8 8
|------|
|.@....|
|......|
|......|
|......|
|......|
|......|
|------|