9 14
|------|
|.@....|-----|
|---........||
|......|-----|
|......|-----|
|............|
|......|--|.||
|......|.....|
|------|-----|